..------.----..
.-------------.
---P--.----P---
------.--------
--.------.----.
----..--------.
----.----------
---P-------P---
.-------.-----.
..---.--.----..
