..--------..
.-P------P-.
.----------.
.---....---.
.---....---.
.---....---.
.---....---.
.----------.
.-P------P-.
..--------..