...............
.-----..------.
.---W----WW---.
.-P-.---------.
.--W-WWWW--WW-.
.---------P-...
.-----..---W--.
.---WW-----W--.
.-W-P---------.
.-W----W---P--.
.----WWWW-W---.
..------------.
...............