...............
.WW---WW------.
.---W---------.
.W-----P----WW.
.W--.---------.
.W-WW---------.
.-----W--WW-P-.
.------W------.
.-P----W------.
.-WW---------W.
.------------W.
.----WW--P----.
.---W-------W-.
.---W---------.
...............