...............
.WW---------WW.
.W-----------W.
.-------------.
.---WWWWWWW---.
.---WP---PW---.
.---W-----W---.
.W--W-----W--W.
.---W-----W---.
.---WP---PW---.
.---WWWWWWW---.
.-------------.
.W-----------W.
.WW---------WW.
...............