..-----------..
.------P------.
---------------
---...---...---
---...---...---
---...---...---
---------------
-P-----------P-
---------------
---...---...---
---...---...---
---...---...---
---------------
.------P------.
..-----------..
...............