.---------.
--P--W--P--
-----W-----
-----------
-----.-----
-WW-...-WW-
-----.-----
-----------
-----W-----
--P--W--P--
.---------.
