..-......-...
.---....---..
--P--..--P--.
.---....---..
..-......-...
.............
.............
..-......-...
.---....---..
--P--..--P--.
.---....---..
..-......-...