............
....-P-.....
...-----....
..-------...
..-P-.-P-...
..-------...
...-----....
....-P-.....
............