-----W-----
-----W-----
--.......--
--.-----.--
--.-P-P-.--
WW.-----.WW
--.-P-P-.--
--.-----.--
--.......--
-----W-----
-----W-----