-----P-----
-----------
--..---..--
--..---..--
-----W-----
P---WWW---P
-----W-----
--..---..--
--..---..--
-----------
-----P-----