.....P-.....
.....--.....
.....--.....
.....--.....
.....--.....
-----------P
P-----------
.....--.....
.....--.....
.....--.....
.....--.....
.....-P.....