............
.-P--.......
.-WW-.......
.---------P-
.---P-------
.-WW-.......
.P---.......
............